GG__O_O____
___S______O
G_O_S_____G
OS_OO______
_______O___
_S_________
_____O_____
___OOOO____
___OG_OOO_O
__SOO______
